Xv, Xv, Xv, Xv, Xv, Xv, Xv
Xv, Xv, Xv, Xv, Xv, Xv, Xv
Xv, Xv, destination Ce, Dd^Ftd, Uh, Xv, Xv
Xv, Xv, Xv, Xv, Hh, Xv, Xv
Xv, Xv, Xv, Hh^Fds, Xv, Xv, Xv
Xv, Xv, Gg, Gg^Fds, Gg, Xv, Xv
Xv, Xv, 1 Gg, Xv, 2 Gg, Xv, Xv
Xv, Xv, Xv, Xv, Xv, Xv, Xv
Xv, Xv, Xv, Xv, Xv, Xv, Xv
